Easy:
[
    [5,0,0,4,6,7,3,0,9],
    [9,0,3,8,1,0,4,2,7],
    [1,7,4,2,0,3,0,0,0],
    [2,3,1,9,7,6,8,5,4],
    [8,5,7,1,2,4,0,9,0],
    [4,9,6,3,0,8,1,7,2],
    [0,0,0,0,8,9,2,6,0],
    [7,8,2,6,4,1,0,0,5],
    [0,1,0,0,0,0,7,0,8]
]

Medium:
[
    [3,0,6,5,0,8,4,0,0],
    [5,2,0,0,0,0,0,0,0],
    [0,8,7,0,0,0,0,3,1],
    [0,0,3,0,1,0,0,8,0],
    [9,0,0,8,6,3,0,0,5],
    [0,5,0,0,9,0,6,0,0],
    [1,3,0,0,0,0,2,5,0],
    [0,0,0,0,0,0,0,7,4],
    [0,0,5,2,0,6,3,0,0]
]

Hard:
[
    [0,5,0,0,0,0,0,0,0],
    [0,0,0,0,0,0,1,0,0],
    [0,0,8,0,0,0,7,9,0],
    [8,0,0,0,1,5,0,0,2],
    [0,0,6,8,0,4,0,0,0],
    [2,0,0,0,6,0,4,0,1],
    [0,0,0,0,0,7,0,0,9],
    [0,1,9,0,0,0,0,5,0],
    [6,4,7,0,0,0,0,0,0]
]